value	label
A	A
AA	AA
AAN	AAN
AAP	AAP
AAT	AAT
AB	AB
ABB	ABB
ABBV	ABBV
ABC	ABC
ABEV	ABEV
ABG	ABG
ABM	ABM
ABR	ABR
ABR-A	ABR-A
ABR-B	ABR-B
ABR-C	ABR-C
ABT	ABT
AC	AC
ACA	ACA
ACB	ACB
ACC	ACC
ACCO	ACCO
ACE.W	ACE.W
ACEL	ACEL
ACH	ACH
ACI	ACI
ACM	ACM
ACN	ACN
ACP	ACP
ACRE	ACRE
ACV	ACV
ADC	ADC
ADCT	ADCT
ADM	ADM
ADNT	ADNT
ADS	ADS
ADSW	ADSW
ADT	ADT
ADX	ADX
AEB	AEB
AEE	AEE
AEFC	AEFC
AEG	AEG
AEL	AEL
AEL-A	AEL-A
AEL-B	AEL-B
AEM	AEM
AEO	AEO
AEP	AEP
AEP-B	AEP-B
AER	AER
AES	AES
AFB	AFB
AFC	AFC
AFG	AFG
AFGB	AFGB
AFGC	AFGC
AFGD	AFGD
AFGH	AFGH
AFI	AFI
AFL	AFL
AFT	AFT
AG	AG
AGCO	AGCO
AGD	AGD
AGI	AGI
AGM	AGM
AGM-A	AGM-A
AGM-C	AGM-C
AGM-D	AGM-D
AGM-E	AGM-E
AGM.A	AGM.A
AGO	AGO
AGO-B	AGO-B
AGO-E	AGO-E
AGO-F	AGO-F
AGR	AGR
AGRO	AGRO
AGS	AGS
AGX	AGX
AHC	AHC
AHH	AHH
AHH-A	AHH-A
AHL-C	AHL-C
AHL-D	AHL-D
AHL-E	AHL-E
AHT	AHT
AHT-D	AHT-D
AHT-F	AHT-F
AHT-G	AHT-G
AHT-H	AHT-H
AHT-I	AHT-I
AI	AI
AI-B	AI-B
AI-C	AI-C
AIC	AIC
AIF	AIF
AIG	AIG
AIG-A	AIG-A
AIG.W	AIG.W
AIN	AIN
AIO	AIO
AIR	AIR
AIT	AIT
AIV	AIV
AIW	AIW
AIZ	AIZ
AIZP	AIZP
AJG	AJG
AJRD	AJRD
AJX	AJX
AJXA	AJXA
AKO.A	AKO.A
AKO.B	AKO.B
AKR	AKR
AL	AL
AL-A	AL-A
ALB	ALB
ALC	ALC
ALE	ALE
ALEX	ALEX
ALG	ALG
ALI-A	ALI-A
ALI-B	ALI-B
ALI-E	ALI-E
ALK	ALK
ALL	ALL
ALL-B	ALL-B
ALL-G	ALL-G
ALL-H	ALL-H
ALL-I	ALL-I
ALL-Y	ALL-Y
ALLE	ALLE
ALLY	ALLY
ALP-Q	ALP-Q
ALSN	ALSN
ALT.W	ALT.W
ALTG	ALTG
ALU.U	ALU.U
ALU.W	ALU.W
ALUS	ALUS
ALV	ALV
ALX	ALX
AM	AM
AMB.W	AMB.W
AMBC	AMBC
AMC	AMC
AMCR	AMCR
AME	AME
AMG	AMG
AMH	AMH
AMH-D	AMH-D
AMH-E	AMH-E
AMH-F	AMH-F
AMH-G	AMH-G
AMH-H	AMH-H
AMK	AMK
AMN	AMN
AMOV	AMOV
AMP	AMP
AMPY	AMPY
AMRC	AMRC
AMRX	AMRX
AMT	AMT
AMX	AMX
AN	AN
ANET	ANET
ANF	ANF
ANH	ANH
ANH-A	ANH-A
ANH-B	ANH-B
ANH-C	ANH-C
ANTM	ANTM
AOD	AOD
AON	AON
AOS	AOS
AP	AP
APA	APA
APAM	APAM
APD	APD
APG	APG
APH	APH
APHA	APHA
APLE	APLE
APO	APO
APO-A	APO-A
APO-B	APO-B
APRN	APRN
APT-A	APT-A
APTS	APTS
APTV	APTV
APY	APY
AQN	AQN
AQNA	AQNA
AQNB	AQNB
AQUA	AQUA
AR	AR
ARA	ARA
ARC	ARC
ARCH	ARCH
ARCO	ARCO
ARD	ARD
ARDC	ARDC
ARE	ARE
ARE-A	ARE-A
ARES	ARES
ARGD	ARGD
ARGO	ARGO
ARI	ARI
ARL	ARL
ARLO	ARLO
ARMK	ARMK
ARNC	ARNC
AROC	AROC
ARR	ARR
ARR-C	ARR-C
ARW	ARW
ASA	ASA
ASB	ASB
ASB-C	ASB-C
ASB-D	ASB-D
ASB-E	ASB-E
ASB-F	ASB-F
ASC	ASC
ASG	ASG
ASGN	ASGN
ASH	ASH
ASIX	ASIX
ASPN	ASPN
ASR	ASR
ASX	ASX
AT	AT
ATC-D	ATC-D
ATC-E	ATC-E
ATC-G	ATC-G
ATC-H	ATC-H
ATC-I	ATC-I
ATCO	ATCO
ATEN	ATEN
ATGE	ATGE
ATH	ATH
ATH-A	ATH-A
ATH-B	ATH-B
ATH-C	ATH-C
ATHM	ATHM
ATI	ATI
ATKR	ATKR
ATO	ATO
ATR	ATR
ATTO	ATTO
ATUS	ATUS
ATV	ATV
AU	AU
AUY	AUY
AVA	AVA
AVAL	AVAL
AVB	AVB
AVD	AVD
AVK	AVK
AVLR	AVLR
AVNS	AVNS
AVT-A	AVT-A
AVTR	AVTR
AVY	AVY
AVYA	AVYA
AWF	AWF
AWI	AWI
AWK	AWK
AWP	AWP
AWR	AWR
AX	AX
AXE	AXE
AXL	AXL
AXO	AXO
AXP	AXP
AXR	AXR
AXS	AXS
AXS-E	AXS-E
AXTA	AXTA
AYI	AYI
AYX	AYX
AZEK	AZEK
AZN	AZN
AZO	AZO
AZRE	AZRE
AZUL	AZUL
AZZ	AZZ
B	B
BA	BA
BABA	BABA
BAC	BAC
BAC-A	BAC-A
BAC-B	BAC-B
BAC-C	BAC-C
BAC-E	BAC-E
BAC-K	BAC-K
BAC-L	BAC-L
BAC-M	BAC-M
BAC-N	BAC-N
BAF	BAF
BAH	BAH
BAK	BAK
BAM	BAM
BAN-D	BAN-D
BAN-E	BAN-E
BANC	BANC
BAP	BAP
BAX	BAX
BB	BB
BBAR	BBAR
BBD	BBD
BBDC	BBDC
BBDO	BBDO
BBF	BBF
BBK	BBK
BBL	BBL
BBN	BBN
BBU	BBU
BBVA	BBVA
BBW	BBW
BBX	BBX
BBY	BBY
BC	BC
BC-A	BC-A
BC-B	BC-B
BC-C	BC-C
BCC	BCC
BCE	BCE
BCEI	BCEI
BCH	BCH
BCO	BCO
BCS	BCS
BCS.P	BCS.P
BCSF	BCSF
BCX	BCX
BDC	BDC
BDJ	BDJ
BDN	BDN
BDX	BDX
BDXB	BDXB
BE	BE
BEDU	BEDU
BEN	BEN
BEP	BEP
BEP-A	BEP-A
BERY	BERY
BEST	BEST
BF.A	BF.A
BF.B	BF.B
BFAM	BFAM
BFK	BFK
BFO	BFO
BFS	BFS
BFS-D	BFS-D
BFS-E	BFS-E
BFY	BFY
BFZ	BFZ
BG	BG
BGB	BGB
BGG	BGG
BGH	BGH
BGIO	BGIO
BGR	BGR
BGS	BGS
BGSF	BGSF
BGT	BGT
BGX	BGX
BGY	BGY
BH	BH
BH.A	BH.A
BHC	BHC
BHE	BHE
BHK	BHK
BHLB	BHLB
BHP	BHP
BHR	BHR
BHR-B	BHR-B
BHR-D	BHR-D
BHV	BHV
BHVN	BHVN
BIF	BIF
BIG	BIG
BILL	BILL
BIO	BIO
BIO.B	BIO.B
BIP	BIP
BIPC	BIPC
BIT	BIT
BITA	BITA
BJ	BJ
BK	BK
BK-C	BK-C
BKD	BKD
BKE	BKE
BKH	BKH
BKI	BKI
BKK	BKK
BKN	BKN
BKR	BKR
BKT	BKT
BKU	BKU
BLD	BLD
BLE	BLE
BLK	BLK
BLL	BLL
BLW	BLW
BLX	BLX
BMA	BMA
BME	BME
BMEZ	BMEZ
BMI	BMI
BML-G	BML-G
BML-H	BML-H
BML-J	BML-J
BML-L	BML-L
BMO	BMO
BMR.U	BMR.U
BMR.W	BMR.W
BMRG	BMRG
BMY	BMY
BMY.P	BMY.P
BNED	BNED
BNS	BNS
BNY	BNY
BOE	BOE
BOH	BOH
BOOT	BOOT
BORR	BORR
BOX	BOX
BP	BP
BPMP	BPMP
BPT	BPT
BQH	BQH
BR	BR
BRBR	BRBR
BRC	BRC
BRFS	BRFS
BRK.A	BRK.A
BRK.B	BRK.B
BRMK	BRMK
BRO	BRO
BRT	BRT
BRX	BRX
BSA	BSA
BSAC	BSAC
BSBR	BSBR
BSD	BSD
BSE	BSE
BSIG	BSIG
BSL	BSL
BSM	BSM
BSMX	BSMX
BST	BST
BSTZ	BSTZ
BSX	BSX
BSX-A	BSX-A
BTA	BTA
BTE	BTE
BTI	BTI
BTO	BTO
BTT	BTT
BTU	BTU
BTZ	BTZ
BUD	BUD
BUI	BUI
BURL	BURL
BV	BV
BVN	BVN
BW	BW
BWA	BWA
BWG	BWG
BWXT	BWXT
BX	BX
BXC	BXC
BXG	BXG
BXMT	BXMT
BXMX	BXMX
BXP	BXP
BXP-B	BXP-B
BXS	BXS
BXS-A	BXS-A
BY	BY
BYD	BYD
BYM	BYM
BZH	BZH
BZM	BZM
C	C
C-J	C-J
C-K	C-K
C-N	C-N
C-S	C-S
CAAP	CAAP
CABO	CABO
CACI	CACI
CADE	CADE
CAE	CAE
CAF	CAF
CAG	CAG
CAH	CAH
CAI	CAI
CAI-A	CAI-A
CAI-B	CAI-B
CAJ	CAJ
CAL	CAL
CALX	CALX
CANG	CANG
CAPL	CAPL
CARR	CARR
CARS	CARS
CAT	CAT
CATO	CATO
CB	CB
CBB	CBB
CBB-B	CBB-B
CBD	CBD
CBH	CBH
CBL	CBL
CBL-D	CBL-D
CBL-E	CBL-E
CBRE	CBRE
CBT	CBT
CBU	CBU
CBZ	CBZ
CC	CC
CCA.U	CCA.U
CCA.W	CCA.W
CCAC	CCAC
CCC	CCC
CCEP	CCEP
CCH	CCH
CCH.U	CCH.U
CCH.W	CCH.W
CCI	CCI
CCI-A	CCI-A
CCJ	CCJ
CCK	CCK
CCL	CCL
CCM	CCM
CCO	CCO
CCR	CCR
CCS	CCS
CCU	CCU
CCX	CCX
CCX.U	CCX.U
CCX.W	CCX.W
CCXX	CCXX
CCZ	CCZ
CDAY	CDAY
CDE	CDE
CDR	CDR
CDR-B	CDR-B
CDR-C	CDR-C
CE	CE
CEA	CEA
CEE	CEE
CEIX	CEIX
CEL	CEL
CEL.P	CEL.P
CELP	CELP
CEM	CEM
CEN	CEN
CEO	CEO
CEPU	CEPU
CEQ.P	CEQ.P
CEQP	CEQP
CF	CF
CFG	CFG
CFG-D	CFG-D
CFG-E	CFG-E
CFR	CFR
CFX	CFX
CFXA	CFXA
CGA	CGA
CGC	CGC
CHA	CHA
CHAP	CHAP
CHCT	CHCT
CHD	CHD
CHE	CHE
CHGG	CHGG
CHH	CHH
CHK	CHK
CHK-D	CHK-D
CHL	CHL
CHM-A	CHM-A
CHM-B	CHM-B
CHMI	CHMI
CHN	CHN
CHRA	CHRA
CHS	CHS
CHT	CHT
CHU	CHU
CHWY	CHWY
CHX	CHX
CHX.P	CHX.P
CI	CI
CIA	CIA
CIB	CIB
CIEN	CIEN
CIF	CIF
CIG	CIG
CIG.C	CIG.C
CII	CII
CIM	CIM
CIM-A	CIM-A
CIM-B	CIM-B
CIM-C	CIM-C
CIM-D	CIM-D
CINR	CINR
CIO	CIO
CIO-A	CIO-A
CIR	CIR
CIT	CIT
CIT-B	CIT-B
CKH	CKH
CL	CL
CLB	CLB
CLDR	CLDR
CLDT	CLDT
CLF	CLF
CLGX	CLGX
CLH	CLH
CLI	CLI
CLN-G	CLN-G
CLN-H	CLN-H
CLN-I	CLN-I
CLN-J	CLN-J
CLNC	CLNC
CLNY	CLNY
CLPR	CLPR
CLR	CLR
CLS	CLS
CLW	CLW
CLX	CLX
CM	CM
CMA	CMA
CMC	CMC
CMCM	CMCM
CMD	CMD
CMG	CMG
CMI	CMI
CMO	CMO
CMO-E	CMO-E
CMP	CMP
CMR-B	CMR-B
CMR-C	CMR-C
CMR-D	CMR-D
CMR-E	CMR-E
CMRE	CMRE
CMS	CMS
CMS-B	CMS-B
CMSA	CMSA
CMSC	CMSC
CMSD	CMSD
CMU	CMU
CNA	CNA
CNC	CNC
CNF	CNF
CNHI	CNHI
CNI	CNI
CNK	CNK
CNMD	CNMD
CNNE	CNNE
CNO	CNO
CNP	CNP
CNP-B	CNP-B
CNQ	CNQ
CNR	CNR
CNS	CNS
CNX	CNX
CNXM	CNXM
CO	CO
COD-A	COD-A
COD-B	COD-B
COD-C	COD-C
CODI	CODI
COE	COE
COF	COF
COF-F	COF-F
COF-G	COF-G
COF-H	COF-H
COF-I	COF-I
COF-J	COF-J
COG	COG
COLD	COLD
COO	COO
COP	COP
COR	COR
COR-Z	COR-Z
CORR	CORR
COTY	COTY
CP	CP
CPA	CPA
CPAC	CPAC
CPB	CPB
CPE	CPE
CPF	CPF
CPG	CPG
CPK	CPK
CPLG	CPLG
CPRI	CPRI
CPS	CPS
CPT	CPT
CR	CR
CRC	CRC
CRD.A	CRD.A
CRD.B	CRD.B
CRH	CRH
CRI	CRI
CRK	CRK
CRL	CRL
CRM	CRM
CRS	CRS
CRT	CRT
CRY	CRY
CS	CS
CSL	CSL
CSLT	CSLT
CSPR	CSPR
CSTM	CSTM
CSU	CSU
CSV	CSV
CTA-A	CTA-A
CTA-B	CTA-B
CTAA	CTAA
CTB	CTB
CTBB	CTBB
CTDD	CTDD
CTK	CTK
CTL	CTL
CTLT	CTLT
CTR	CTR
CTRA	CTRA
CTS	CTS
CTT	CTT
CTV	CTV
CTVA	CTVA
CTY	CTY
CTZ	CTZ
CUB	CUB
CUB-C	CUB-C
CUB-D	CUB-D
CUB-E	CUB-E
CUB-F	CUB-F
CUBB	CUBB
CUBE	CUBE
CUBI	CUBI
CUK	CUK
CULP	CULP
CURO	CURO
CUZ	CUZ
CVA	CVA
CVE	CVE
CVEO	CVEO
CVI	CVI
CVIA	CVIA
CVNA	CVNA
CVS	CVS
CVX	CVX
CW	CW
CWE.A	CWE.A
CWEN	CWEN
CWH	CWH
CWK	CWK
CWT	CWT
CX	CX
CXE	CXE
CXH	CXH
CXO	CXO
CXP	CXP
CXW	CXW
CYD	CYD
CYH	CYH
CZZ	CZZ
D	D
DAC	DAC
DAL	DAL
DAN	DAN
DAO	DAO
DAR	DAR
DAVA	DAVA
DB	DB
DBD	DBD
DBI	DBI
DBL	DBL
DCF	DCF
DCI	DCI
DCO	DCO
DCP	DCP
DCP-B	DCP-B
DCP-C	DCP-C
DCUE	DCUE
DD	DD
DDD	DDD
DDF	DDF
DDS	DDS
DDT	DDT
DE	DE
DEA	DEA
DECK	DECK
DEI	DEI
DELL	DELL
DEO	DEO
DESP	DESP
DEX	DEX
DFIN	DFIN
DFN.U	DFN.U
DFN.W	DFN.W
DFNS	DFNS
DFP	DFP
DFS	DFS
DG	DG
DGX	DGX
DHF	DHF
DHI	DHI
DHR	DHR
DHR-A	DHR-A
DHR-B	DHR-B
DHT	DHT
DHX	DHX
DIAX	DIAX
DIN	DIN
DIS	DIS
DK	DK
DKL	DKL
DKS	DKS
DL	DL
DLB	DLB
DLN-A	DLN-A
DLN-B	DLN-B
DLNG	DLNG
DLPH	DLPH
DLR	DLR
DLR-C	DLR-C
DLR-G	DLR-G
DLR-I	DLR-I
DLR-J	DLR-J
DLR-K	DLR-K
DLR-L	DLR-L
DLX	DLX
DLY	DLY
DMB	DMB
DMO	DMO
DMY.U	DMY.U
DMY.W	DMY.W
DMYT	DMYT
DNI	DNI
DNK	DNK
DNOW	DNOW
DNP	DNP
DNR	DNR
DOC	DOC
DOOR	DOOR
DOV	DOV
DOW	DOW
DPG	DPG
DPZ	DPZ
DQ	DQ
DRD	DRD
DRE	DRE
DRH	DRH
DRI	DRI
DRQ	DRQ
DRUA	DRUA
DS	DS
DS-B	DS-B
DS-C	DS-C
DS-D	DS-D
DSE	DSE
DSL	DSL
DSM	DSM
DSSI	DSSI
DSU	DSU
DSX	DSX
DSX-B	DSX-B
DT	DT
DTE	DTE
DTF	DTF
DTJ	DTJ
DTL.P	DTL.P
DTP	DTP
DTQ	DTQ
DTW	DTW
DTY	DTY
DUC	DUC
DUK	DUK
DUK-A	DUK-A
DUKB	DUKB
DUKH	DUKH
DVA	DVA
DVD	DVD
DVN	DVN
DX	DX
DX-B	DX-B
DX-C	DX-C
DXC	DXC
DY	DY
E	E
EAB	EAB
EAE	EAE
EAF	EAF
EAI	EAI
EARN	EARN
EAT	EAT
EB	EB
EBF	EBF
EBR	EBR
EBR.B	EBR.B
EBS	EBS
EC	EC
ECC	ECC
ECCB	ECCB
ECCX	ECCX
ECCY	ECCY
ECL	ECL
ECOM	ECOM
ECT	ECT
ED	ED
EDD	EDD
EDF	EDF
EDI	EDI
EDN	EDN
EDU	EDU
EE	EE
EEA	EEA
EEX	EEX
EFC	EFC
EFC-A	EFC-A
EFF	EFF
EFL	EFL
EFR	EFR
EFT	EFT
EFX	EFX
EGF	EGF
EGHT	EGHT
EGIF	EGIF
EGO	EGO
EGP	EGP
EGY	EGY
EHC	EHC
EHI	EHI
EHT	EHT
EIC	EIC
EIG	EIG
EIX	EIX
EL	EL
ELAN	ELAN
ELAT	ELAT
ELC	ELC
ELF	ELF
ELJ	ELJ
ELP	ELP
ELS	ELS
ELU	ELU
ELVT	ELVT
ELY	ELY
EMD	EMD
EME	EME
EMF	EMF
EMN	EMN
EMO	EMO
EMP	EMP
EMR	EMR
ENB	ENB
ENBA	ENBA
ENBL	ENBL
ENIA	ENIA
ENIC	ENIC
ENJ	ENJ
ENLC	ENLC
ENO	ENO
ENR	ENR
ENR-A	ENR-A
ENS	ENS
ENV	ENV
ENVA	ENVA
ENZ	ENZ
EOD	EOD
EOG	EOG
EOI	EOI
EOS	EOS
EOT	EOT
EP-C	EP-C
EPAC	EPAC
EPAM	EPAM
EPC	EPC
EPD	EPD
EPR	EPR
EPR-C	EPR-C
EPR-E	EPR-E
EPR-G	EPR-G
EPRT	EPRT
EQC	EQC
EQC-D	EQC-D
EQH	EQH
EQH-A	EQH-A
EQM	EQM
EQNR	EQNR
EQR	EQR
EQS	EQS
EQT	EQT
ERA	ERA
ERF	ERF
ERJ	ERJ
EROS	EROS
ES	ES
ESE	ESE
ESI	ESI
ESNT	ESNT
ESRT	ESRT
ESS	ESS
ESTC	ESTC
ESTE	ESTE
ET	ET
ETB	ETB
ETG	ETG
ETH	ETH
ETI.P	ETI.P
ETJ	ETJ
ETM	ETM
ETN	ETN
ETO	ETO
ETP-C	ETP-C
ETP-D	ETP-D
ETP-E	ETP-E
ETR	ETR
ETRN	ETRN
ETV	ETV
ETW	ETW
ETX	ETX
ETY	ETY
EURN	EURN
EV	EV
EVA	EVA
EVC	EVC
EVF	EVF
EVG	EVG
EVH	EVH
EVN	EVN
EVR	EVR
EVRG	EVRG
EVRI	EVRI
EVT	EVT
EVTC	EVTC
EW	EW
EXD	EXD
EXG	EXG
EXK	EXK
EXP	EXP
EXPR	EXPR
EXR	EXR
EXTN	EXTN
EZT	EZT
F	F
F-B	F-B
F-C	F-C
FAF	FAF
FAM	FAM
FBC	FBC
FBHS	FBHS
FBK	FBK
FBM	FBM
FBP	FBP
FC	FC
FCAU	FCAU
FCF	FCF
FCN	FCN
FCPT	FCPT
FCT	FCT
FCX	FCX
FDEU	FDEU
FDP	FDP
FDS	FDS
FDX	FDX
FE	FE
FEA.U	FEA.U
FEA.W	FEA.W
FEAC	FEAC
FEDU	FEDU
FEI	FEI
FENG	FENG
FEO	FEO
FET	FET
FF	FF
FFA	FFA
FFC	FFC
FFG	FFG
FG	FG
FG.W	FG.W
FGB	FGB
FHI	FHI
FHN	FHN
FHN-A	FHN-A
FHN-E	FHN-E
FI	FI
FICO	FICO
FIF	FIF
FINS	FINS
FINV	FINV
FIS	FIS
FIT	FIT
FIV	FIV
FIX	FIX
FL	FL
FLC	FLC
FLNG	FLNG
FLO	FLO
FLOW	FLOW
FLR	FLR
FLS	FLS
FLT	FLT
FLY	FLY
FMC	FMC
FMN	FMN
FMO	FMO
FMS	FMS
FMX	FMX
FMY	FMY
FN	FN
FNB	FNB
FNB-E	FNB-E
FND	FND
FNF	FNF
FNV	FNV
FOE	FOE
FOF	FOF
FOR	FOR
FOUR	FOUR
FPA.U	FPA.U
FPA.W	FPA.W
FPAC	FPAC
FPF	FPF
FPH	FPH
FPI	FPI
FPI-B	FPI-B
FPL	FPL
FR	FR
FRA	FRA
FRC	FRC
FRC-F	FRC-F
FRC-G	FRC-G
FRC-H	FRC-H
FRC-I	FRC-I
FRC-J	FRC-J
FRO	FRO
FRT	FRT
FRT-C	FRT-C
FSB	FSB
FSD	FSD
FSK	FSK
FSKR	FSKR
FSLF	FSLF
FSLY	FSLY
FSM	FSM
FSS	FSS
FT	FT
FTA-A	FTA-A
FTA-B	FTA-B
FTAI	FTAI
FTCH	FTCH
FTI	FTI
FTK	FTK
FTS	FTS
FTV	FTV
FTV-A	FTV-A
FUL	FUL
FUN	FUN
FVA.U	FVA.U
FVAC	FVAC
FVRR	FVRR
G	G
GAB	GAB
GAB-G	GAB-G
GAB-H	GAB-H
GAB-J	GAB-J
GAB-K	GAB-K
GAM	GAM
GAM-B	GAM-B
GATX	GATX
GBAB	GBAB
GBL	GBL
GBX	GBX
GCAP	GCAP
GCI	GCI
GCO	GCO
GCP	GCP
GCV	GCV
GD	GD
GDDY	GDDY
GDL	GDL
GDL-C	GDL-C
GDO	GDO
GDOT	GDOT
GDV	GDV
GDV-A	GDV-A
GDV-G	GDV-G
GDV-H	GDV-H
GE	GE
GEF	GEF
GEF.B	GEF.B
GEL	GEL
GEN	GEN
GEO	GEO
GER	GER
GES	GES
GF	GF
GFF	GFF
GFI	GFI
GFL	GFL
GFLU	GFLU
GFY	GFY
GGB	GGB
GGG	GGG
GGM	GGM
GGT	GGT
GGT-E	GGT-E
GGT-G	GGT-G
GGZ	GGZ
GGZ-A	GGZ-A
GHC	GHC
GHG	GHG
GHL	GHL
GHM	GHM
GHY	GHY
GIB	GIB
GIK.U	GIK.U
GIL	GIL
GIM	GIM
GIS	GIS
GIX	GIX
GIX.P	GIX.P
GIX.U	GIX.U
GIX.W	GIX.W
GJH	GJH
GJO	GJO
GJP	GJP
GJR	GJR
GJS	GJS
GJT	GJT
GKOS	GKOS
GL	GL
GL-C	GL-C
GLE.U	GLE.U
GLE.W	GLE.W
GLEO	GLEO
GLO-A	GLO-A
GLO-B	GLO-B
GLO-C	GLO-C
GLO-G	GLO-G
GLOB	GLOB
GLOG	GLOG
GLOP	GLOP
GLP	GLP
GLP-A	GLP-A
GLT	GLT
GLW	GLW
GM	GM
GME	GME
GMED	GMED
GMR-A	GMR-A
GMRE	GMRE
GMS	GMS
GMTA	GMTA
GMZ	GMZ
GNC	GNC
GNE	GNE
GNE-A	GNE-A
GNK	GNK
GNL	GNL
GNL-A	GNL-A
GNL-B	GNL-B
GNRC	GNRC
GNT	GNT
GNT-A	GNT-A
GNW	GNW
GOF	GOF
GOL	GOL
GOLD	GOLD
GOLF	GOLF
GOOS	GOOS
GPC	GPC
GPI	GPI
GPJA	GPJA
GPK	GPK
GPM	GPM
GPMT	GPMT
GPN	GPN
GPRK	GPRK
GPS	GPS
GPX	GPX
GRA	GRA
GRA.U	GRA.U
GRA.W	GRA.W
GRAF	GRAF
GRAM	GRAM
GRC	GRC
GRP.U	GRP.U
GRUB	GRUB
GRX	GRX
GRX-B	GRX-B
GS	GS
GS-A	GS-A
GS-C	GS-C
GS-D	GS-D
GS-J	GS-J
GS-K	GS-K
GS-N	GS-N
GSBD	GSBD
GSH	GSH
GSK	GSK
GSL	GSL
GSL-B	GSL-B
GSLD	GSLD
GSX	GSX
GTES	GTES
GTN	GTN
GTN.A	GTN.A
GTS	GTS
GTT	GTT
GTX	GTX
GTY	GTY
GUT	GUT
GUT-A	GUT-A
GUT-C	GUT-C
GVA	GVA
GWB	GWB
GWRE	GWRE
GWW	GWW
GYC	GYC
H	H
HAE	HAE
HAL	HAL
HASI	HASI
HBB	HBB
HBI	HBI
HBM	HBM
HCA	HCA
HCC	HCC
HCFT	HCFT
HCHC	HCHC
HCI	HCI
HCR	HCR
HCXY	HCXY
HCXZ	HCXZ
HD	HD
HDB	HDB
HE	HE
HEI	HEI
HEI.A	HEI.A
HEP	HEP
HEQ	HEQ
HES	HES
HESM	HESM
HEXO	HEXO
HFC	HFC
HFR-A	HFR-A
HFRO	HFRO
HGH	HGH
HGLB	HGLB
HGV	HGV
HHC	HHC
HHS	HHS
HI	HI
HIE	HIE
HIG	HIG
HIG-G	HIG-G
HII	HII
HIL	HIL
HIO	HIO
HIW	HIW
HIX	HIX
HKIB	HKIB
HL	HL
HL-B	HL-B
HLF	HLF
HLI	HLI
HLT	HLT
HLX	HLX
HMC	HMC
HMI	HMI
HML-A	HML-A
HMLP	HMLP
HMN	HMN
HMY	HMY
HNGR	HNGR
HNI	HNI
HNP	HNP
HOG	HOG
HOME	HOME
HON	HON
HOV	HOV
HP	HP
HPE	HPE
HPF	HPF
HPI	HPI
HPP	HPP
HPQ	HPQ
HPR	HPR
HPS	HPS
HQH	HQH
HQL	HQL
HR	HR
HRB	HRB
HRC	HRC
HRI	HRI
HRL	HRL
HRTG	HRTG
HSB-A	HSB-A
HSBC	HSBC
HSC	HSC
HST	HST
HSY	HSY
HT	HT
HT-C	HT-C
HT-D	HT-D
HT-E	HT-E
HTA	HTA
HTD	HTD
HTFA	HTFA
HTGC	HTGC
HTH	HTH
HTY	HTY
HTZ	HTZ
HUBB	HUBB
HUBS	HUBS
HUD	HUD
HUM	HUM
HUN	HUN
HUYA	HUYA
HVT	HVT
HVT.A	HVT.A
HWM	HWM
HXL	HXL
HY	HY
HYB	HYB
HYI	HYI
HYT	HYT
HZN	HZN
HZO	HZO
IAA	IAA
IAE	IAE
IAG	IAG
IBA	IBA
IBM	IBM
IBN	IBN
IBP	IBP
ICD	ICD
ICE	ICE
ICL	ICL
IDA	IDA
IDE	IDE
IDT	IDT
IEX	IEX
IFF	IFF
IFFT	IFFT
IFN	IFN
IFS	IFS
IGA	IGA
IGD	IGD
IGI	IGI
IGR	IGR
IGT	IGT
IHC	IHC
IHD	IHD
IHG	IHG
IHIT	IHIT
IHTA	IHTA
IID	IID
IIF	IIF
IIM	IIM
IIP-A	IIP-A
IIPR	IIPR
IMAX	IMAX
INFO	INFO
INFY	INFY
ING	ING
INGR	INGR
INN	INN
INN-D	INN-D
INN-E	INN-E
INS-A	INS-A
INSI	INSI
INSP	INSP
INSW	INSW
INT	INT
INVH	INVH
IO	IO
IP	IP
IPG	IPG
IPHI	IPHI
IPI	IPI
IPO.U	IPO.U
IPO.W	IPO.W
IPOB	IPOB
IPOC	IPOC
IPV	IPV
IPV.U	IPV.U
IPV.W	IPV.W
IQI	IQI
IQV	IQV
IR	IR
IRE-C	IRE-C
IRET	IRET
IRL	IRL
IRM	IRM
IRR	IRR
IRS	IRS
IRT	IRT
ISD	ISD
IT	IT
ITCB	ITCB
ITGR	ITGR
ITT	ITT
ITUB	ITUB
ITW	ITW
IVC	IVC
IVH	IVH
IVR	IVR
IVR-A	IVR-A
IVR-B	IVR-B
IVR-C	IVR-C
IVZ	IVZ
IX	IX
J	J
JAX	JAX
JBGS	JBGS
JBK	JBK
JBL	JBL
JBT	JBT
JCA-B	JCA-B
JCAP	JCAP
JCE	JCE
JCI	JCI
JCO	JCO
JDD	JDD
JE	JE
JE-A	JE-A
JEF	JEF
JELD	JELD
JEMD	JEMD
JEQ	JEQ
JFR	JFR
JGH	JGH
JHAA	JHAA
JHB	JHB
JHG	JHG
JHI	JHI
JHS	JHS
JHX	JHX
JHY	JHY
JIH	JIH
JIH.U	JIH.U
JIH.W	JIH.W
JILL	JILL
JKS	JKS
JLL	JLL
JLS	JLS
JMIA	JMIA
JMM	JMM
JMP	JMP
JNJ	JNJ
JNPR	JNPR
JOE	JOE
JOF	JOF
JP	JP
JPC	JPC
JPI	JPI
JPM	JPM
JPM-C	JPM-C
JPM-D	JPM-D
JPM-G	JPM-G
JPM-H	JPM-H
JPM-J	JPM-J
JPS	JPS
JPT	JPT
JQC	JQC
JRI	JRI
JRO	JRO
JRS	JRS
JSD	JSD
JT	JT
JTA	JTA
JTD	JTD
JW.A	JW.A
JW.B	JW.B
JWN	JWN
JWS.U	JWS.U
K	K
KAI	KAI
KAMN	KAMN
KAR	KAR
KB	KB
KBH	KBH
KBR	KBR
KDMN	KDMN
KDP	KDP
KEM	KEM
KEN	KEN
KEP	KEP
KEX	KEX
KEY	KEY
KEY-I	KEY-I
KEY-J	KEY-J
KEY-K	KEY-K
KEYS	KEYS
KF	KF
KFS	KFS
KFY	KFY
KGC	KGC
KIM	KIM
KIM-L	KIM-L
KIM-M	KIM-M
KIO	KIO
KKR	KKR
KKR-A	KKR-A
KKR-B	KKR-B
KL	KL
KMB	KMB
KMF	KMF
KMI	KMI
KMPR	KMPR
KMT	KMT
KMX	KMX
KN	KN
KNL	KNL
KNOP	KNOP
KNX	KNX
KO	KO
KODK	KODK
KOF	KOF
KOP	KOP
KOS	KOS
KR	KR
KRA	KRA
KRC	KRC
KREF	KREF
KRG	KRG
KRO	KRO
KRP	KRP
KSM	KSM
KSS	KSS
KSU	KSU
KSU.P	KSU.P
KT	KT
KTB	KTB
KTF	KTF
KTH	KTH
KTN	KTN
KW	KW
KWR	KWR
KYN	KYN
L	L
LAC	LAC
LAD	LAD
LADR	LADR
LAIX	LAIX
LAZ	LAZ
LB	LB
LBRT	LBRT
LC	LC
LCI	LCI
LCII	LCII
LDL	LDL
LDOS	LDOS
LDP	LDP
LEA	LEA
LEAF	LEAF
LEE	LEE
LEG	LEG
LEJU	LEJU
LEN	LEN
LEN.B	LEN.B
LEO	LEO
LEVI	LEVI
LFC	LFC
LGC	LGC
LGC.U	LGC.U
LGC.W	LGC.W
LGF.A	LGF.A
LGF.B	LGF.B
LGI	LGI
LGV.U	LGV.U
LH	LH
LHC	LHC
LHC.U	LHC.U
LHC.W	LHC.W
LHX	LHX
LII	LII
LIN	LIN
LINX	LINX
LITB	LITB
LL	LL
LLY	LLY
LM	LM
LMHA	LMHA
LMHB	LMHB
LMT	LMT
LN	LN
LNC	LNC
LND	LND
LNN	LNN
LOA.U	LOA.U
LOA.W	LOA.W
LOAK	LOAK
LOMA	LOMA
LOW	LOW
LPG	LPG
LPI	LPI
LPL	LPL
LPX	LPX
LRN	LRN
LSI	LSI
LTC	LTC
LTHM	LTHM
LTM	LTM
LUB	LUB
LUV	LUV
LVS	LVS
LW	LW
LXFR	LXFR
LXP	LXP
LXP-C	LXP-C
LXU	LXU
LYB	LYB
LYG	LYG
LYV	LYV
LZB	LZB
M	M
MA	MA
MAA	MAA
MAA-I	MAA-I
MAC	MAC
MAIN	MAIN
MAN	MAN
MANU	MANU
MAS	MAS
MATX	MATX
MAV	MAV
MAXR	MAXR
MBI	MBI
MBT	MBT
MC	MC
MCA	MCA
MCB	MCB
MCC	MCC
MCD	MCD
MCI	MCI
MCK	MCK
MCN	MCN
MCO	MCO
MCR	MCR
MCS	MCS
MCV	MCV
MCX	MCX
MCY	MCY
MD	MD
MDC	MDC
MDLA	MDLA
MDLQ	MDLQ
MDLX	MDLX
MDLY	MDLY
MDP	MDP
MDT	MDT
MDU	MDU
MEC	MEC
MED	MED
MEI	MEI
MEN	MEN
MER-K	MER-K
MET	MET
MET-A	MET-A
MET-E	MET-E
MET-F	MET-F
MFA	MFA
MFA-B	MFA-B
MFA-C	MFA-C
MFA.U	MFA.U
MFA.W	MFA.W
MFAC	MFAC
MFC	MFC
MFD	MFD
MFG	MFG
MFGP	MFGP
MFL	MFL
MFM	MFM
MFO	MFO
MFT	MFT
MFV	MFV
MG	MG
MGA	MGA
MGF	MGF
MGM	MGM
MGP	MGP
MGR	MGR
MGU	MGU
MGY	MGY
MH-A	MH-A
MH-C	MH-C
MH-D	MH-D
MHD	MHD
MHE	MHE
MHF	MHF
MHI	MHI
MHK	MHK
MHLA	MHLA
MHN	MHN
MHNC	MHNC
MHO	MHO
MIC	MIC
MIE	MIE
MIN	MIN
MIT-A	MIT-A
MIT-B	MIT-B
MIT-C	MIT-C
MITT	MITT
MIXT	MIXT
MIY	MIY
MKC	MKC
MKC.V	MKC.V
MKL	MKL
MLI	MLI
MLM	MLM
MLP	MLP
MLR	MLR
MMC	MMC
MMD	MMD
MMI	MMI
MMM	MMM
MMP	MMP
MMS	MMS
MMT	MMT
MMU	MMU
MN	MN
MNE	MNE
MNK	MNK
MNP	MNP
MNR	MNR
MNR-C	MNR-C
MNRL	MNRL
MO	MO
MOD	MOD
MODN	MODN
MOG.A	MOG.A
MOG.B	MOG.B
MOGU	MOGU
MOH	MOH
MOS	MOS
MOV	MOV
MPA	MPA
MPC	MPC
MPLX	MPLX
MPV	MPV
MPW	MPW
MPX	MPX
MQT	MQT
MQY	MQY
MR	MR
MRC	MRC
MRK	MRK
MRO	MRO
MS	MS
MS-A	MS-A
MS-E	MS-E
MS-F	MS-F
MS-I	MS-I
MS-K	MS-K
MS-L	MS-L
MSA	MSA
MSB	MSB
MSC	MSC
MSCI	MSCI
MSD	MSD
MSGE	MSGE
MSGN	MSGN
MSGS	MSGS
MSI	MSI
MSM	MSM
MT	MT
MTB	MTB
MTCN	MTCN
MTD	MTD
MTDR	MTDR
MTG	MTG
MTH	MTH
MTL	MTL
MTL.P	MTL.P
MTN	MTN
MTOR	MTOR
MTR	MTR
MTRN	MTRN
MTT	MTT
MTW	MTW
MTX	MTX
MTZ	MTZ
MUA	MUA
MUC	MUC
MUE	MUE
MUFG	MUFG
MUH	MUH
MUI	MUI
MUJ	MUJ
MUR	MUR
MUS	MUS
MUSA	MUSA
MUX	MUX
MVC	MVC
MVCD	MVCD
MVF	MVF
MVO	MVO
MVT	MVT
MWA	MWA
MX	MX
MXE	MXE
MXF	MXF
MXL	MXL
MYC	MYC
MYD	MYD
MYE	MYE
MYF	MYF
MYI	MYI
MYJ	MYJ
MYN	MYN
MYOV	MYOV
MZA	MZA
NAC	NAC
NAD	NAD
NAN	NAN
NAT	NAT
NAV	NAV
NAV-D	NAV-D
NAZ	NAZ
NBB	NBB
NBHC	NBHC
NBR	NBR
NBR-A	NBR-A
NC	NC
NCA	NCA
NCB	NCB
NCLH	NCLH
NCR	NCR
NCV	NCV
NCV-A	NCV-A
NCZ	NCZ
NCZ-A	NCZ-A
NDP	NDP
NE	NE
NEA	NEA
NEE	NEE
NEE-I	NEE-I
NEE-J	NEE-J
NEE-K	NEE-K
NEE-N	NEE-N
NEE-O	NEE-O
NEE-P	NEE-P
NEM	NEM
NEP	NEP
NET	NET
NEU	NEU
NEV	NEV
NEW	NEW
NEWR	NEWR
NEX	NEX
NEXA	NEXA
NFG	NFG
NFH	NFH
NFH.W	NFH.W
NFJ	NFJ
NGG	NGG
NGL	NGL
NGL-A	NGL-A
NGL-B	NGL-B
NGL-C	NGL-C
NGS	NGS
NGVC	NGVC
NGVT	NGVT
NHA	NHA
NHF	NHF
NHI	NHI
NI	NI
NI-B	NI-B
NID	NID
NIE	NIE
NIM	NIM
NINE	NINE
NIO	NIO
NIQ	NIQ
NJR	NJR
NJV	NJV
NKE	NKE
NKG	NKG
NKX	NKX
NL	NL
NLS	NLS
NLSN	NLSN
NLY	NLY
NLY-D	NLY-D
NLY-F	NLY-F
NLY-G	NLY-G
NLY-I	NLY-I
NM	NM
NM-G	NM-G
NM-H	NM-H
NMCO	NMCO
NMFC	NMFC
NMFX	NMFX
NMI	NMI
NMK-B	NMK-B
NMK-C	NMK-C
NMM	NMM
NMR	NMR
NMS	NMS
NMT	NMT
NMY	NMY
NMZ	NMZ
NNA	NNA
NNI	NNI
NNN	NNN
NNN-F	NNN-F
NNY	NNY
NOA	NOA
NOAH	NOAH
NOC	NOC
NOK	NOK
NOM	NOM
NOMD	NOMD
NOV	NOV
NOVA	NOVA
NOW	NOW
NP	NP
NPK	NPK
NPN	NPN
NPO	NPO
NPTN	NPTN
NPV	NPV
NQP	NQP
NR	NR
NREF	NREF
NRG	NRG
NRGX	NRGX
NRK	NRK
NRP	NRP
NRT	NRT
NRUC	NRUC
NRZ	NRZ
NRZ-A	NRZ-A
NRZ-B	NRZ-B
NRZ-C	NRZ-C
NS	NS
NS-A	NS-A
NS-B	NS-B
NS-C	NS-C
NSA	NSA
NSA-A	NSA-A
NSC	NSC
NSC.W	NSC.W
NSCO	NSCO
NSL	NSL
NSP	NSP
NSS	NSS
NTB	NTB
NTCO	NTCO
NTEST.I	NTEST.I
NTEST.J	NTEST.J
NTEST.K	NTEST.K
NTG	NTG
NTP	NTP
NTR	NTR
NTZ	NTZ
NUE	NUE
NUM	NUM
NUO	NUO
NUS	NUS
NUV	NUV
NUW	NUW
NVG	NVG
NVGS	NVGS
NVO	NVO
NVR	NVR
NVRO	NVRO
NVS	NVS
NVST	NVST
NVT	NVT
NVTA	NVTA
NWE	NWE
NWHM	NWHM
NWN	NWN
NX	NX
NXC	NXC
NXJ	NXJ
NXN	NXN
NXP	NXP
NXQ	NXQ
NXR	NXR
NXRT	NXRT
NYC-A	NYC-A
NYC-U	NYC-U
NYCB	NYCB
NYT	NYT
NYV	NYV
NZF	NZF
O	O
OAC	OAC
OAC.U	OAC.U
OAC.W	OAC.W
OAK-A	OAK-A
OAK-B	OAK-B
OC	OC
OCFT	OCFT
OCN	OCN
ODC	ODC
OEC	OEC
OFC	OFC
OFG	OFG
OFG-A	OFG-A
OFG-B	OFG-B
OFG-D	OFG-D
OGE	OGE
OGS	OGS
OHI	OHI
OI	OI
OIA	OIA
OIB.C	OIB.C
OII	OII
OIS	OIS
OKE	OKE
OLN	OLN
OLP	OLP
OMC	OMC
OMF	OMF
OMI	OMI
ONDK	ONDK
ONE	ONE
ONTO	ONTO
OOMA	OOMA
OPP	OPP
OPY	OPY
OR	OR
ORA	ORA
ORAN	ORAN
ORC	ORC
ORCC	ORCC
ORCL	ORCL
ORI	ORI
ORN	ORN
OSB	OSB
OSG	OSG
OSK	OSK
OTIS	OTIS
OUT	OUT
OVV	OVV
OXM	OXM
OXY	OXY
PAA	PAA
PAC	PAC
PAC.W	PAC.W
PACD	PACD
PACK	PACK
PAG	PAG
PAGP	PAGP
PAGS	PAGS
PAI	PAI
PAM	PAM
PANW	PANW
PAR	PAR
PARR	PARR
PAYC	PAYC
PB	PB
PBA	PBA
PBB	PBB
PBC	PBC
PBF	PBF
PBFX	PBFX
PBH	PBH
PBI	PBI
PBI-B	PBI-B
PBR	PBR
PBR.A	PBR.A
PBT	PBT
PBY	PBY
PCF	PCF
PCG	PCG
PCI	PCI
PCK	PCK
PCM	PCM
PCN	PCN
PCP.U	PCP.U
PCPL	PCPL
PCQ	PCQ
PD	PD
PDI	PDI
PDM	PDM
PDS	PDS
PDT	PDT
PE	PE
PEAK	PEAK
PEB	PEB
PEB-C	PEB-C
PEB-D	PEB-D
PEB-E	PEB-E
PEB-F	PEB-F
PEG	PEG
PEI	PEI
PEI-B	PEI-B
PEI-C	PEI-C
PEI-D	PEI-D
PEN	PEN
PEO	PEO
PER	PER
PFD	PFD
PFE	PFE
PFGC	PFGC
PFL	PFL
PFN	PFN
PFO	PFO
PFS	PFS
PFSI	PFSI
PG	PG
PGP	PGP
PGR	PGR
PGRE	PGRE
PGTI	PGTI
PGZ	PGZ
PH	PH
PHD	PHD
PHG	PHG
PHI	PHI
PHK	PHK
PHM	PHM
PHR	PHR
PHT	PHT
PHX	PHX
PIC	PIC
PIC.U	PIC.U
PIC.W	PIC.W
PII	PII
PIM	PIM
PINE	PINE
PING	PING
PINS	PINS
PIPR	PIPR
PJH	PJH
PJT	PJT
PK	PK
PKE	PKE
PKG	PKG
PKI	PKI
PKO	PKO
PKX	PKX
PLAN	PLAN
PLD	PLD
PLNT	PLNT
PLOW	PLOW
PLT	PLT
PLYM	PLYM
PM	PM
PMF	PMF
PML	PML
PMM	PMM
PMO	PMO
PMT	PMT
PMT-A	PMT-A
PMT-B	PMT-B
PMX	PMX
PNC	PNC
PNC-P	PNC-P
PNC-Q	PNC-Q
PNF	PNF
PNI	PNI
PNM	PNM
PNR	PNR
PNW	PNW
POL	POL
POR	POR
POST	POST
PPG	PPG
PPL	PPL
PPR	PPR
PPT	PPT
PPX	PPX
PQG	PQG
PRA	PRA
PRE-F	PRE-F
PRE-G	PRE-G
PRE-H	PRE-H
PRE-I	PRE-I
PRGO	PRGO
PRH	PRH
PRI	PRI
PRI-A	PRI-A
PRI-B	PRI-B
PRI-C	PRI-C
PRI-D	PRI-D
PRI-E	PRI-E
PRI-F	PRI-F
PRLB	PRLB
PRMW	PRMW
PRO	PRO
PROS	PROS
PRS	PRS
PRSP	PRSP
PRT	PRT
PRTY	PRTY
PRU	PRU
PSA	PSA
PSA-B	PSA-B
PSA-C	PSA-C
PSA-D	PSA-D
PSA-E	PSA-E
PSA-F	PSA-F
PSA-G	PSA-G
PSA-H	PSA-H
PSA-I	PSA-I
PSA-J	PSA-J
PSA-K	PSA-K
PSA-L	PSA-L
PSA-V	PSA-V
PSA-W	PSA-W
PSA-X	PSA-X
PSB	PSB
PSB-W	PSB-W
PSB-X	PSB-X
PSB-Y	PSB-Y
PSB-Z	PSB-Z
PSF	PSF
PSN	PSN
PSO	PSO
PSTG	PSTG
PSTL	PSTL
PSV	PSV
PSX	PSX
PSXP	PSXP
PTR	PTR
PTY	PTY
PUK	PUK
PUK-A	PUK-A
PUK.P	PUK.P
PUMP	PUMP
PVG	PVG
PVH	PVH
PVL	PVL
PWR	PWR
PXD	PXD
PYN	PYN
PYS	PYS
PYT	PYT
PYX	PYX
PZC	PZC
PZN	PZN
QD	QD
QEP	QEP
QES	QES
QGEN	QGEN
QSR	QSR
QTS	QTS
QTS-A	QTS-A
QTS-B	QTS-B
QTWO	QTWO
QUAD	QUAD
QUOT	QUOT
QVCC	QVCC
QVCD	QVCD
R	R
RA	RA
RACE	RACE
RAD	RAD
RAMP	RAMP
RBA	RBA
RBC	RBC
RBS	RBS
RC	RC
RCA	RCA
RCB	RCB
RCI	RCI
RCL	RCL
RCP	RCP
RCS	RCS
RCUS	RCUS
RDN	RDN
RDS.A	RDS.A
RDS.B	RDS.B
RDY	RDY
RE	RE
RELX	RELX
RENN	RENN
RES	RES
RESI	RESI
REV	REV
REVG	REVG
REX	REX
REX-A	REX-A
REX-B	REX-B
REX-C	REX-C
REXR	REXR
REZI	REZI
RF	RF
RF-A	RF-A
RF-B	RF-B
RF-C	RF-C
RFI	RFI
RFL	RFL
RFM	RFM
RFP	RFP
RGA	RGA
RGR	RGR
RGS	RGS
RGT	RGT
RH	RH
RHI	RHI
RHP	RHP
RIG	RIG
RIO	RIO
RIV	RIV
RJF	RJF
RL	RL
RLGY	RLGY
RLH	RLH
RLI	RLI
RLJ	RLJ
RLJ-A	RLJ-A
RM	RM
RMAX	RMAX
RMD	RMD
RMED	RMED
RMG	RMG
RMG.U	RMG.U
RMG.W	RMG.W
RMI	RMI
RMM	RMM
RMP.P	RMP.P
RMT	RMT
RNG	RNG
RNGR	RNGR
RNP	RNP
RNR	RNR
RNR-E	RNR-E
RNR-F	RNR-F
ROG	ROG
ROK	ROK
ROL	ROL
ROP	ROP
ROYT	ROYT
RPAI	RPAI
RPL.U	RPL.U
RPL.W	RPL.W
RPLA	RPLA
RPM	RPM
RPT	RPT
RPT-D	RPT-D
RQI	RQI
RRC	RRC
RRD	RRD
RS	RS
RSF	RSF
RSG	RSG
RST	RST
RTW	RTW
RTX	RTX
RUBI	RUBI
RVI	RVI
RVLV	RVLV
RVT	RVT
RWT	RWT
RXN	RXN
RY	RY
RY-T	RY-T
RYAM	RYAM
RYB	RYB
RYCE	RYCE
RYI	RYI
RYN	RYN
RZA	RZA
RZB	RZB
SA	SA
SAF	SAF
SAFE	SAFE
SAH	SAH
SAIC	SAIC
SAIL	SAIL
SALT	SALT
SAM	SAM
SAN	SAN
SAN-B	SAN-B
SAND	SAND
SAP	SAP
SAR	SAR
SAVE	SAVE
SB	SB
SB-C	SB-C
SB-D	SB-D
SBBA	SBBA
SBE	SBE
SBE.U	SBE.U
SBE.W	SBE.W
SBH	SBH
SBI	SBI
SBOW	SBOW
SBR	SBR
SBS	SBS
SBSW	SBSW
SC	SC
SCA	SCA
SCCO	SCCO
SCD	SCD
SCE-G	SCE-G
SCE-H	SCE-H
SCE-J	SCE-J
SCE-K	SCE-K
SCE-L	SCE-L
SCH-C	SCH-C
SCH-D	SCH-D
SCHW	SCHW
SCI	SCI
SCL	SCL
SCM	SCM
SCP.U	SCP.U
SCP.W	SCP.W
SCPE	SCPE
SCS	SCS
SCU	SCU
SCV.U	SCV.U
SCV.W	SCV.W
SCVX	SCVX
SCX	SCX
SD	SD
SDRL	SDRL
SE	SE
SEAS	SEAS
SEE	SEE
SEM	SEM
SERV	SERV
SF	SF
SF-A	SF-A
SF-B	SF-B
SF-C	SF-C
SFB	SFB
SFE	SFE
SFL	SFL
SFT.U	SFT.U
SFT.W	SFT.W
SFTW	SFTW
SFUN	SFUN
SGU	SGU
SHAK	SHAK
SHG	SHG
SHI	SHI
SHL.U	SHL.U
SHL.W	SHL.W
SHLL	SHLL
SHLX	SHLX
SHO	SHO
SHO-E	SHO-E
SHO-F	SHO-F
SHOP	SHOP
SHW	SHW
SI	SI
SID	SID
SIG	SIG
SII	SII
SIT-A	SIT-A
SIT-K	SIT-K
SITC	SITC
SITE	SITE
SIX	SIX
SJI	SJI
SJIJ	SJIJ
SJIU	SJIU
SJM	SJM
SJR	SJR
SJT	SJT
SJW	SJW
SKM	SKM
SKT	SKT
SKX	SKX
SKY	SKY
SLB	SLB
SLCA	SLCA
SLF	SLF
SLG	SLG
SLG-I	SLG-I
SLQT	SLQT
SM	SM
SMAR	SMAR
SMFG	SMFG
SMG	SMG
SMHI	SMHI
SMLP	SMLP
SMM	SMM
SMP	SMP
SNA	SNA
SNAP	SNAP
SNDR	SNDR
SNE	SNE
SNN	SNN
SNP	SNP
SNR	SNR
SNV	SNV
SNV-D	SNV-D
SNV-E	SNV-E
SNX	SNX
SO	SO
SOA.U	SOA.U
SOA.W	SOA.W
SOGO	SOGO
SOI	SOI
SOJA	SOJA
SOJB	SOJB
SOJC	SOJC
SOJD	SOJD
SOL	SOL
SOLN	SOLN
SON	SON
SOR	SOR
SPA.U	SPA.U
SPA.W	SPA.W
SPAQ	SPAQ
SPB	SPB
SPCE	SPCE
SPE	SPE
SPE-B	SPE-B
SPG	SPG
SPG-J	SPG-J
SPGI	SPGI
SPH	SPH
SPL-A	SPL-A
SPLP	SPLP
SPN	SPN
SPOT	SPOT
SPR	SPR
SPXC	SPXC
SPXX	SPXX
SQ	SQ
SQM	SQM
SQNS	SQNS
SR	SR
SR-A	SR-A
SRC	SRC
SRC-A	SRC-A
SRE	SRE
SRE-A	SRE-A
SRE-B	SRE-B
SREA	SREA
SRG	SRG
SRG-A	SRG-A
SRI	SRI
SRL	SRL
SRLP	SRLP
SRT	SRT
SRV	SRV
SSD	SSD
SSL	SSL
SSTK	SSTK
ST	ST
STA-C	STA-C
STA-D	STA-D
STA-G	STA-G
STA-I	STA-I
STAG	STAG
STAR	STAR
STC	STC
STE	STE
STG	STG
STK	STK
STL	STL
STL-A	STL-A
STM	STM
STN	STN
STNG	STNG
STON	STON
STOR	STOR
STT	STT
STT-D	STT-D
STT-G	STT-G
STWD	STWD
STZ	STZ
STZ.B	STZ.B
SU	SU
SUI	SUI
SUM	SUM
SUN	SUN
SUP	SUP
SUPV	SUPV
SUZ	SUZ
SWCH	SWCH
SWI	SWI
SWK	SWK
SWM	SWM
SWN	SWN
SWT	SWT
SWX	SWX
SWZ	SWZ
SXC	SXC
SXI	SXI
SXT	SXT
SYF	SYF
SYF-A	SYF-A
SYK	SYK
SYX	SYX
SYY	SYY
SZC	SZC
T	T
T-A	T-A
T-C	T-C
TAC	TAC
TAK	TAK
TAL	TAL
TALO	TALO
TAP	TAP
TAP.A	TAP.A
TARO	TARO
TBB	TBB
TBC	TBC
TBI	TBI
TCI	TCI
TCO	TCO
TCO-J	TCO-J
TCO-K	TCO-K
TCP	TCP
TCRW	TCRW
TCRZ	TCRZ
TCS	TCS
TD	TD
TDA	TDA
TDC	TDC
TDE	TDE
TDF	TDF
TDG	TDG
TDI	TDI
TDJ	TDJ
TDOC	TDOC
TDS	TDS
TDW	TDW
TDW.A	TDW.A
TDW.B	TDW.B
TDY	TDY
TEAF	TEAF
TECK	TECK
TEF	TEF
TEI	TEI
TEL	TEL
TEN	TEN
TEO	TEO
TEVA	TEVA
TEX	TEX
TFC	TFC
TFC-F	TFC-F
TFC-G	TFC-G
TFC-H	TFC-H
TFC-I	TFC-I
TFC-O	TFC-O
TFII	TFII
TFX	TFX
TG	TG
TGH	TGH
TGI	TGI
TGNA	TGNA
TGP	TGP
TGP-A	TGP-A
TGP-B	TGP-B
TGS	TGS
TGT	TGT
THC	THC
THG	THG
THGA	THGA
THO	THO
THQ	THQ
THR	THR
THS	THS
THW	THW
TIF	TIF
TISI	TISI
TJX	TJX
TK	TK
TKC	TKC
TKR	TKR
TLI	TLI
TLK	TLK
TLRD	TLRD
TLYS	TLYS
TM	TM
TME	TME
TMHC	TMHC
TMO	TMO
TMST	TMST
TNC	TNC
TNET	TNET
TNK	TNK
TNP	TNP
TNP-C	TNP-C
TNP-D	TNP-D
TNP-E	TNP-E
TNP-F	TNP-F
TOL	TOL
TOT	TOT
TPB	TPB
TPC	TPC
TPH	TPH
TPL	TPL
TPR	TPR
TPRE	TPRE
TPVG	TPVG
TPVY	TPVY
TPX	TPX
TPZ	TPZ
TR	TR
TRC	TRC
TREC	TREC
TREX	TREX
TRGP	TRGP
TRI	TRI
TRN	TRN
TRN.U	TRN.U
TRN.W	TRN.W
TRNE	TRNE
TRNO	TRNO
TROX	TROX
TRP	TRP
TRQ	TRQ
TRT-A	TRT-A
TRT-B	TRT-B
TRT-C	TRT-C
TRT-D	TRT-D
TRTN	TRTN
TRTX	TRTX
TRU	TRU
TRV	TRV
TRWH	TRWH
TS	TS
TSE	TSE
TSI	TSI
TSLX	TSLX
TSM	TSM
TSN	TSN
TSQ	TSQ
TSU	TSU
TT	TT
TTC	TTC
TTI	TTI
TTM	TTM
TTP	TTP
TU	TU
TUFN	TUFN
TUP	TUP
TV	TV
TVC	TVC
TVE	TVE
TWI	TWI
TWLO	TWLO
TWN	TWN
TWO	TWO
TWO-A	TWO-A
TWO-B	TWO-B
TWO-C	TWO-C
TWO-D	TWO-D
TWO-E	TWO-E
TWTR	TWTR
TX	TX
TXT	TXT
TY	TY
TY.P	TY.P
TYG	TYG
TYL	TYL
UA	UA
UAA	UAA
UAN	UAN
UBA	UBA
UBER	UBER
UBP	UBP
UBP-H	UBP-H
UBP-K	UBP-K
UBS	UBS
UDR	UDR
UE	UE
UFI	UFI
UFS	UFS
UGI	UGI
UGP	UGP
UHS	UHS
UHT	UHT
UI	UI
UIS	UIS
UL	UL
UMC	UMC
UMH	UMH
UMH-B	UMH-B
UMH-C	UMH-C
UMH-D	UMH-D
UN	UN
UNF	UNF
UNFI	UNFI
UNH	UNH
UNM	UNM
UNMA	UNMA
UNP	UNP
UNVR	UNVR
UPS	UPS
URI	URI
USA	USA
USAC	USAC
USB	USB
USB-A	USB-A
USB-H	USB-H
USB-M	USB-M
USB-O	USB-O
USB-P	USB-P
USDP	USDP
USFD	USFD
USM	USM
USNA	USNA
USPH	USPH
USX	USX
UTF	UTF
UTI	UTI
UTL	UTL
UVE	UVE
UVV	UVV
UZA	UZA
UZB	UZB
UZC	UZC
V	V
VAC	VAC
VAL	VAL
VALE	VALE
VAM	VAM
VAPO	VAPO
VAR	VAR
VBF	VBF
VCIF	VCIF
VCRA	VCRA
VCV	VCV
VEC	VEC
VEDL	VEDL
VEEV	VEEV
VEL	VEL
VER	VER
VER-F	VER-F
VER.U	VER.U
VET	VET
VFC	VFC
VGI	VGI
VGM	VGM
VGR	VGR
VHI	VHI
VICI	VICI
VIPS	VIPS
VIST	VIST
VIV	VIV
VJET	VJET
VKQ	VKQ
VLO	VLO
VLRS	VLRS
VLT	VLT
VMC	VMC
VMI	VMI
VMO	VMO
VMW	VMW
VNCE	VNCE
VNE	VNE
VNO	VNO
VNO-K	VNO-K
VNO-L	VNO-L
VNO-M	VNO-M
VNTR	VNTR
VOC	VOC
VOY-B	VOY-B
VOYA	VOYA
VPG	VPG
VPV	VPV
VRS	VRS
VRT	VRT
VRT.W	VRT.W
VRTV	VRTV
VSH	VSH
VSLR	VSLR
VST	VST
VST.A	VST.A
VSTO	VSTO
VTA	VTA
VTN	VTN
VTOL	VTOL
VTR	VTR
VVI	VVI
VVN.W	VVN.W
VVNT	VVNT
VVR	VVR
VVV	VVV
VZ	VZ
W	W
WAB	WAB
WAL	WAL
WALA	WALA
WAT	WAT
WBAI	WBAI
WBK	WBK
WBS	WBS
WBS-F	WBS-F
WBT	WBT
WCC	WCC
WCC-A	WCC-A
WCN	WCN
WD	WD
WDR	WDR
WEA	WEA
WEC	WEC
WEI	WEI
WELL	WELL
WES	WES
WEX	WEX
WF	WF
WFC	WFC
WFC-L	WFC-L
WFC-N	WFC-N
WFC-O	WFC-O
WFC-P	WFC-P
WFC-Q	WFC-Q
WFC-R	WFC-R
WFC-T	WFC-T
WFC-V	WFC-V
WFC-W	WFC-W
WFC-X	WFC-X
WFC-Y	WFC-Y
WFC-Z	WFC-Z
WGO	WGO
WH	WH
WHD	WHD
WHG	WHG
WHR	WHR
WIA	WIA
WIT	WIT
WIW	WIW
WK	WK
WLK	WLK
WLKP	WLKP
WLL	WLL
WM	WM
WMB	WMB
WMC	WMC
WMK	WMK
WMS	WMS
WMT	WMT
WNC	WNC
WNS	WNS
WOR	WOR
WORK	WORK
WOW	WOW
WPC	WPC
WPF.U	WPF.U
WPG	WPG
WPG-H	WPG-H
WPG-I	WPG-I
WPM	WPM
WPP	WPP
WPX	WPX
WRB	WRB
WRB-B	WRB-B
WRB-C	WRB-C
WRB-D	WRB-D
WRB-E	WRB-E
WRB-F	WRB-F
WRE	WRE
WRI	WRI
WRK	WRK
WSM	WSM
WSO	WSO
WSO.B	WSO.B
WSR	WSR
WST	WST
WTI	WTI
WTM	WTM
WTRG	WTRG
WTRU	WTRU
WTS	WTS
WTTR	WTTR
WU	WU
WUBA	WUBA
WWE	WWE
WWW	WWW
WY	WY
WYND	WYND
X	X
XAN	XAN
XAN-C	XAN-C
XEC	XEC
XFLT	XFLT
XHR	XHR
XIN	XIN
XOM	XOM
XPO	XPO
XRF	XRF
XRX	XRX
XYF	XYF
XYL	XYL
Y	Y
YELP	YELP
YETI	YETI
YEXT	YEXT
YPF	YPF
YRD	YRD
YUM	YUM
YUMC	YUMC
ZBH	ZBH
ZEN	ZEN
ZNH	ZNH
ZTO	ZTO
ZTR	ZTR
ZTS	ZTS
ZUO	ZUO
ZYME	ZYME
